111111
100C11
1P0011
100E11
111111
111111