1111111111111111111111111111111111111111
1000000000001111111111100000000000000001
100100000000000000000100000000000C000001
1001000000000000000001000000000000000001
1001000000000000000000000000000000000001
1001000000000000001110000000000000000001
1001000111111111111110000000000000000001
1000000000000000000000000000000000000001
1000000000000000000000111111111111000001
100000000C000000000000000000000001000001
1000001111111111111111110000000001000001
1000000000100000000000000000000100000011
1000000000100000000111111111110000000001
1000000000110000000000000000000000000001
1000000000010000000000000000000000000001
1000011111111100000000000000000000000001
1000000000000000000000000000000000000001
100000PE00000000000000000000111110000001
1000000000000000000000000000000000000001
100000000011111111111111100000000C000001
1000000000010000000000000000000000000001
1111111111111111111111111111111111111111
1111111111111111111111111111111111111111
1111111111111111111111111111111111111111
1111111111111111111111111111111111111111
1111111111111111111111111111111111111111
1111111111111111111111111111111111111111
1111111111111111111111111111111111111111
1111111111111111111111111111111111111111
1111111111111111111111111111111111111111
1111111111111111111111111111111111111111
1111111111111111111111111111111111111111
1111111111111111111111111111111111111111
1111111111111111111111111111111111111111
1111111111111111111111111111111111111111
1111111111111111111111111111111111111111
1111111111111111111111111111111111111111
1111111111111111111111111111111111111111
1111111111111111111111111111111111111111
1111111111111111111111111111111111111111
1111111111111111111111111111111111111111
1111111111111111111111111111111111111111
1111111111111111111111111111111111111111
1111111111111111111111111111111111111111
1111111111111111111111111111111111111111
1111111111111111111111111111111111111111
1111111111111111111111111111111111111111
1111111111111111111111111111111111111111