11111111111111111111111111111111
10000000100001000000000111000001
10010010110101011110000011000E01
10010010010100010000010011000001
10010010010111111111111111110111
100100000000000000000000000C0001
1001111000011111110P001100000001
11111111111111111111111111111111